0 0 0 0 0 0 0 0 0 0 0 0 0 0 0 0 0 0 0 0 0 0 0 0 0 0 0 0 0 0 0 0 0 0 0 0 0 0 0 0 0 0 0 0 0 0 0 0 0 0 0 0 0 0 0 0 0 0 0 0 0 0 0 0 0 0 0 0 0 0 0 0 0 0 0 0 0 0 0 0 0 0 0 0 0 0 0 0 0 0 0 0 0 0 0 0 0 0 0 0 
0 0 0 0 0 0 0 0 0 0 0 0 0 0 0 0 0 0 0 0 0 0 0 0 0 0 0 0 0 0 0 0 0 0 0 0 0 0 0 0 0 0 0 0 0 0 0 0 0 0 0 0 0 0 0 0 0 0 0 0 0 0 0 0 0 0 0 0 0 0 0 0 0 0 0 0 0 0 0 0 0 0 0 0 0 0 0 0 0 0 0 0 0 0 0 0 0 0 0 0 
0 0 0 0 0 0 0 0 0 0 0 0 0 0 0 0 0 0 0 0 0 0 0 0 0 0 0 0 0 0 0 0 0 0 0 0 0 0 0 0 0 0 0 0 0 0 0 0 0 0 0 0 0 0 0 0 0 0 0 0 0 0 0 0 0 0 0 0 0 0 0 0 0 0 0 0 0 0 0 0 0 0 0 0 0 0 0 0 0 0 0 0 0 0 0 0 0 0 0 0 
0 0 0 0 0 0 0 0 0 0 0 0 0 0 0 0 0 0 0 0 0 0 0 0 0 0 0 0 0 0 0 0 0 0 0 0 0 0 0 0 0 0 0 0 0 0 0 0 0 0 0 0 0 0 0 0 0 0 0 0 0 0 0 0 0 0 0 0 0 0 0 0 0 0 0 0 0 0 0 0 0 0 0 0 0 0 0 0 0 0 0 0 0 0 0 0 0 0 0 0 
0 0 0 0 0 0 0 0 0 0 0 0 0 0 0 0 0 0 0 0 0 0 0 0 0 0 0 0 0 0 0 0 0 0 0 0 0 0 0 0 0 0 0 0 0 0 0 0 0 0 0 0 0 0 0 0 0 0 0 0 0 0 0 0 0 0 0 0 0 0 0 0 0 0 0 0 0 0 0 0 0 0 0 0 0 0 0 0 0 0 0 0 0 0 0 0 0 0 0 0 
0 0 0 0 0 0 0 0 0 0 0 0 0 0 0 0 0 0 0 0 0 0 0 0 0 0 0 0 0 0 0 0 0 0 0 0 0 0 0 0 0 0 0 0 0 0 0 0 0 0 0 0 0 0 0 0 0 0 0 0 0 0 0 0 0 0 0 0 0 0 0 0 0 0 0 0 0 0 0 0 0 0 0 0 0 0 0 0 0 0 0 0 0 0 0 0 0 0 0 0 
0 0 0 0 0 0 0 0 0 0 0 0 0 0 0 0 0 0 0 0 0 0 0 0 0 0 0 0 0 0 0 0 0 0 0 0 0 0 0 0 0 0 0 0 0 0 0 0 0 0 0 0 0 0 0 0 0 0 0 0 0 0 0 0 0 0 0 0 0 0 0 0 0 0 0 0 0 0 0 0 0 0 0 0 0 0 0 0 0 0 0 0 0 0 0 0 0 0 0 0 
0 0 0 0 0 0 0 0 0 0 0 0 0 0 0 0 0 0 0 0 0 0 0 0 0 0 0 0 0 0 0 0 0 0 0 0 0 0 0 0 0 0 0 0 0 0 0 0 0 0 0 0 0 0 0 0 0 0 0 0 0 0 0 0 0 0 0 0 0 0 0 0 0 0 0 0 0 0 0 0 0 0 0 0 0 0 0 0 0 0 0 0 0 0 0 0 0 0 0 0 
0 0 0 0 0 0 0 0 0 0 0 0 0 0 0 0 0 0 0 0 0 0 0 0 0 0 0 0 0 0 0 0 0 0 0 0 0 0 0 0 0 0 0 0 0 0 0 0 0 0 0 0 0 0 0 0 0 0 0 0 0 0 0 0 0 0 0 0 0 0 0 0 0 0 0 0 0 0 0 0 0 0 0 0 0 0 0 0 0 0 0 0 0 0 0 0 0 0 0 0 
0 0 0 0 0 0 0 0 0 0 0 0 0 0 0 0 0 0 0 0 0 0 0 0 0 0 0 0 0 0 0 0 0 0 0 0 0 0 0 0 0 0 0 0 0 0 0 0 0 0 0 0 0 0 0 0 0 0 0 0 0 0 0 0 0 0 0 0 0 0 0 0 0 0 0 0 0 0 0 0 0 0 0 0 0 0 0 0 0 0 0 0 0 0 0 0 0 0 0 0 
0 0 0 0 0 0 0 0 0 0 0 0 0 0 0 0 0 0 0 0 0 0 0 0 0 0 0 0 0 0 0 0 0 0 0 0 0 0 0 0 0 0 0 0 0 0 0 0 0 0 0 0 0 0 0 0 0 0 0 0 0 0 0 0 0 0 0 0 0 0 0 0 0 0 0 0 0 0 0 0 0 0 0 0 0 0 0 0 0 0 0 0 0 0 0 0 0 0 0 0 
0 0 0 0 0 0 0 0 0 0 0 0 0 0 0 0 0 0 0 0 0 0 0 0 0 0 0 0 0 0 0 0 0 0 0 0 0 0 0 0 0 0 0 0 0 0 0 0 0 0 0 0 0 0 0 0 0 0 0 0 0 0 0 0 0 0 0 0 0 0 0 0 0 0 0 0 0 0 0 0 0 0 0 0 0 0 0 0 0 0 0 0 0 0 0 0 0 0 0 0 
0 0 0 0 0 0 0 0 0 0 0 0 0 0 0 0 0 0 0 0 0 0 0 0 0 0 0 0 0 0 0 0 0 0 0 0 0 0 0 0 0 0 0 0 0 0 0 0 0 0 0 0 0 0 0 0 0 0 0 0 0 0 0 0 0 0 0 0 0 0 0 0 0 0 0 0 0 0 0 0 0 0 0 0 0 0 0 0 0 0 0 0 0 0 0 0 0 0 0 0 
0 0 0 0 0 0 0 0 0 0 0 0 0 0 0 0 0 0 0 0 0 0 0 0 0 0 0 0 0 0 0 0 0 0 0 0 0 0 0 0 0 0 0 0 0 0 0 0 0 0 0 0 0 0 0 0 0 0 0 0 0 0 0 0 0 0 0 0 0 0 0 0 0 0 0 0 0 0 0 0 0 0 0 0 0 0 0 0 0 0 0 0 0 0 0 0 0 0 0 0 
0 0 0 0 0 0 0 0 0 0 0 0 0 0 0 0 0 0 0 0 0 0 0 0 0 0 0 0 0 0 0 0 0 0 0 0 0 0 0 0 0 0 0 0 0 0 0 0 0 0 0 0 0 0 0 0 0 0 0 0 0 0 0 0 0 0 0 0 0 0 0 0 0 0 0 0 0 0 0 0 0 0 0 0 0 0 0 0 0 0 0 0 0 0 0 0 0 0 0 0 
0 0 0 0 0 0 0 0 0 0 0 0 0 0 0 0 0 0 0 0 0 0 0 0 0 0 0 0 0 0 0 0 0 0 0 0 0 0 0 0 0 0 0 0 0 0 0 0 0 0 0 0 0 0 0 0 0 0 0 0 0 0 0 0 0 0 0 0 0 0 0 0 0 0 0 0 0 0 0 0 0 0 0 0 0 0 0 0 0 0 0 0 0 0 0 0 0 0 0 0 
0 0 0 0 0 0 0 0 0 0 0 0 0 0 0 0 0 0 0 0 0 0 0 0 0 0 0 0 0 0 0 0 0 0 0 0 0 0 0 0 0 0 0 0 0 0 0 0 0 0 0 0 0 0 0 0 0 0 0 0 0 0 0 0 0 0 0 0 0 0 0 0 0 0 0 0 0 0 0 0 0 0 0 0 0 0 0 0 0 0 0 0 0 0 0 0 0 0 0 0 
0 0 0 0 0 0 0 0 0 0 0 0 0 0 0 0 0 0 0 0 0 0 0 0 0 0 0 0 0 0 0 0 0 0 0 0 0 0 0 0 0 0 0 0 0 0 0 0 0 0 0 0 0 0 0 0 0 0 0 0 0 0 0 0 0 0 0 0 0 0 0 0 0 0 0 0 0 0 0 0 0 0 0 0 0 0 0 0 0 0 0 0 0 0 0 0 0 0 0 0 
0 0 0 0 0 0 0 0 0 0 0 0 0 0 0 0 0 0 0 0 0 0 0 0 0 0 0 0 0 0 0 0 0 0 0 0 0 0 0 0 0 0 0 0 0 0 0 0 0 0 0 0 0 0 0 0 0 0 0 0 0 0 0 0 0 0 0 0 0 0 0 0 0 0 0 0 0 0 0 0 0 0 0 0 0 0 0 0 0 0 0 0 0 0 0 0 0 0 0 0 
0 0 0 0 0 0 0 0 0 0 0 0 0 0 0 0 0 0 0 0 0 0 0 0 0 0 0 0 0 0 0 0 0 0 0 0 0 0 0 0 0 0 0 0 0 0 0 0 0 0 0 0 0 0 0 0 0 0 0 0 0 0 0 0 0 0 0 0 0 0 0 0 0 0 0 0 0 0 0 0 0 0 0 0 0 0 0 0 0 0 0 0 0 0 0 0 0 0 0 0 
0 0 0 0 0 0 0 0 0 0 0 0 0 0 0 0 0 0 0 0 0 0 0 0 259 1 0 0 0 0 0 0 0 0 0 0 0 0 0 0 0 0 0 0 0 0 0 0 0 0 0 0 0 0 0 0 0 0 0 0 0 0 0 0 0 0 0 0 0 0 0 0 0 0 0 0 0 0 0 0 0 0 0 0 0 0 0 0 0 0 0 0 0 0 0 0 0 0 0 0 
0 0 0 0 0 0 0 0 0 0 0 0 0 0 0 0 0 0 0 0 0 0 0 0 259 0 0 0 0 0 0 0 0 0 0 0 0 0 0 0 0 0 0 0 0 0 0 0 0 0 0 0 0 0 0 0 0 0 0 0 0 0 0 0 0 0 0 0 0 0 0 0 0 0 0 0 0 0 0 0 0 0 0 0 0 0 0 0 0 0 0 0 0 0 0 0 0 0 0 0 
0 0 0 0 0 0 0 0 0 0 0 0 0 0 0 0 0 0 0 0 0 0 0 259 0 259 259 0 0 0 0 0 0 0 0 0 0 0 0 0 0 0 0 259 0 0 0 0 0 0 5 257 0 6 6 6 6 6 0 0 0 0 0 0 0 0 0 0 0 0 0 0 0 0 0 0 0 0 0 0 0 0 0 0 0 0 0 0 0 0 0 0 0 0 0 0 0 0 0 0 
0 0 0 0 0 0 0 0 0 0 0 0 0 0 0 0 0 0 0 0 0 0 0 0 0 0 259 259 0 0 0 0 0 0 0 0 0 0 0 0 0 0 0 259 259 259 0 0 0 0 0 257 0 0 6 6 0 6 6 0 0 0 0 0 0 0 0 0 0 0 0 0 0 0 0 0 280 0 0 0 0 0 0 0 0 0 0 0 0 0 0 0 0 0 0 0 0 0 0 0 
0 0 0 0 0 0 0 0 0 0 0 0 0 0 0 0 0 0 0 0 0 0 0 0 0 0 0 0 259 259 259 0 0 0 0 0 0 0 2 129 0 0 0 259 259 259 259 6 6 6 6 0 257 6 6 6 6 6 6 6 6 0 0 0 0 0 0 0 0 0 264 0 0 0 0 280 280 0 0 0 0 0 0 0 0 0 0 0 0 0 0 0 0 0 0 0 0 0 0 0 
0 0 0 0 0 0 0 0 0 0 0 0 0 0 0 0 0 0 0 0 0 0 0 0 259 259 259 0 259 0 0 0 0 0 258 3 3 0 0 0 0 0 259 3 259 0 258 259 6 6 0 6 257 4 6 6 6 6 6 0 0 4 4 0 6 0 0 0 0 264 264 264 0 24 280 264 280 0 0 0 0 0 0 0 0 0 0 0 0 0 0 0 0 0 0 0 0 0 0 0 
0 0 0 0 0 0 0 0 0 0 0 0 0 0 0 0 0 0 0 0 0 0 0 1 259 259 259 0 0 0 0 0 0 0 3 3 259 2 2 259 2 0 3 3 259 0 258 0 0 6 6 6 6 6 4 6 6 6 6 0 0 4 4 6 0 0 0 0 0 264 264 264 264 280 264 0 0 0 264 0 0 0 0 0 0 0 0 0 0 0 0 0 0 0 0 0 0 0 0 0 
0 0 0 0 0 0 0 0 0 0 0 0 0 0 0 0 0 0 0 0 0 0 0 259 259 259 8 259 0 0 259 0 0 0 259 0 259 259 0 2 0 3 259 3 259 0 258 6 258 0 6 6 6 6 6 6 6 0 0 6 6 6 4 6 264 0 0 0 264 10 0 264 264 0 0 264 264 264 264 0 0 0 0 0 0 0 0 0 0 0 0 0 0 0 0 0 0 0 0 0 
0 0 0 0 3 0 0 0 0 0 0 0 0 0 0 0 0 0 0 0 0 0 259 259 258 259 259 8 0 259 0 265 0 259 0 259 1 1 0 259 259 17 259 259 259 259 259 259 258 6 6 6 6 6 6 6 6 6 0 6 0 0 0 264 264 6 6 264 264 3 10 264 264 264 264 0 264 264 264 0 0 0 0 0 0 0 0 0 0 0 0 0 0 0 0 0 0 0 0 0 
0 0 0 0 0 0 0 0 0 0 0 0 0 0 0 0 0 0 0 0 0 259 259 259 259 259 259 259 0 0 265 259 259 0 0 259 259 258 258 0 17 0 259 259 259 129 259 0 258 6 6 6 0 6 2 6 6 6 0 6 0 0 264 264 6 6 264 264 264 264 264 264 0 264 0 0 264 264 264 0 0 0 0 0 0 0 0 0 0 0 0 0 0 0 0 0 0 0 0 0 
0 0 0 0 0 0 0 0 0 0 0 0 0 0 0 0 0 0 0 0 0 0 0 0 259 259 259 0 0 0 259 259 259 0 0 259 0 259 0 258 259 258 258 258 258 258 259 259 6 6 6 0 6 0 6 6 6 6 6 14 6 264 264 264 6 328 264 264 264 264 280 0 0 264 80 0 264 0 0 0 0 0 0 0 0 0 0 0 0 0 0 0 0 0 0 0 0 0 0 0 
0 0 0 0 0 0 0 0 0 0 0 0 0 0 0 0 0 0 0 259 0 0 0 259 259 259 0 9 265 265 259 259 0 0 0 3 259 259 1 259 258 258 259 259 258 258 258 6 259 6 6 6 6 6 6 6 6 6 6 14 0 4 8 6 0 0 264 280 280 280 0 0 0 264 0 0 0 0 0 0 0 0 0 0 0 0 0 0 0 0 0 0 0 0 0 0 0 0 0 0 
0 0 0 0 0 0 0 0 0 0 0 0 0 0 0 0 0 0 0 0 0 0 0 0 264 259 265 265 264 259 259 265 0 259 0 259 0 259 259 259 259 258 258 258 0 0 258 6 1 6 6 6 6 6 6 6 6 4 14 4 6 4 264 264 264 264 264 280 264 264 0 0 0 0 264 0 0 0 0 0 0 0 0 0 0 0 0 0 0 0 0 0 0 0 0 0 0 0 0 0 
0 0 0 0 0 0 0 0 0 0 0 0 0 0 0 0 0 0 0 0 259 259 3 0 0 9 265 264 265 265 265 0 265 259 259 3 259 259 259 259 258 258 2 2 258 258 258 0 0 0 6 0 6 0 6 6 6 4 4 6 4 4 4 264 264 264 264 264 264 264 136 136 0 0 0 0 0 0 0 0 0 0 0 0 0 0 0 0 0 0 0 0 0 0 0 0 0 0 0 0 
0 0 0 0 0 0 0 0 0 0 0 0 0 0 0 0 0 0 0 0 0 259 259 0 259 265 9 0 265 265 265 265 1 265 259 17 259 9 259 259 258 0 0 2 258 258 258 2 259 4 6 6 6 0 0 0 4 4 4 4 6 4 0 6 6 264 280 0 264 136 136 280 0 0 0 0 0 0 0 0 0 0 0 0 0 0 0 0 0 0 0 0 0 0 0 0 0 0 0 0 
0 0 0 0 0 0 0 0 0 0 0 0 0 0 0 0 0 0 0 0 0 259 0 0 0 0 265 264 265 265 0 265 259 265 259 259 259 259 9 259 259 258 259 2 2 2 258 258 259 258 6 6 6 0 6 4 0 4 4 4 6 6 264 0 0 264 280 280 264 280 280 280 280 264 0 0 0 0 0 0 0 0 0 0 0 0 0 0 0 0 0 0 0 0 0 0 0 0 0 0 
0 0 0 0 0 0 0 0 0 0 0 0 0 0 0 0 0 0 0 0 259 0 265 0 0 0 265 2 8 265 265 265 259 259 265 265 259 0 259 259 259 259 259 0 17 17 258 259 258 259 6 6 6 0 4 4 4 4 4 4 4 0 6 20 0 20 0 280 264 264 280 280 280 264 0 0 280 0 0 0 0 0 0 0 0 0 0 0 0 0 0 0 0 0 0 0 0 0 0 0 
0 0 0 0 0 0 0 0 0 0 0 0 0 0 0 0 0 0 0 0 0 265 0 137 0 0 0 265 2 8 265 265 265 265 137 265 259 259 259 265 258 259 259 0 258 0 258 258 258 258 6 6 1 6 6 4 4 4 4 4 2 0 6 20 20 0 10 280 280 280 280 280 264 280 280 280 0 0 0 0 0 0 0 0 0 0 0 0 0 0 0 0 0 0 0 0 0 0 0 0 
0 0 0 0 0 0 0 0 0 0 0 0 0 0 0 0 0 0 0 0 0 0 0 0 265 0 265 0 265 8 265 265 265 265 10 10 266 265 259 259 259 258 330 259 259 258 258 258 259 4 6 1 6 6 20 0 4 4 4 0 20 20 20 20 20 0 264 280 280 280 280 280 280 280 280 280 280 0 0 0 0 0 280 280 0 0 0 0 0 0 0 0 0 0 0 0 0 0 0 0 
0 0 0 0 0 0 0 0 0 0 0 0 0 0 0 0 0 0 0 0 0 0 0 265 0 265 265 8 265 265 265 265 265 265 0 266 265 265 265 265 259 259 330 67 259 259 259 4 259 4 128 6 20 4 20 4 0 0 16 20 0 20 20 20 20 280 280 280 280 280 0 280 280 280 280 280 280 280 0 280 0 0 0 280 264 0 0 0 0 0 0 0 0 0 0 0 0 0 0 0 
0 0 0 0 0 0 0 0 0 0 0 0 0 0 0 0 0 0 0 0 0 0 265 0 0 265 265 265 8 265 265 265 265 0 265 265 265 265 265 265 259 265 259 259 259 280 0 259 0 128 6 20 0 4 4 0 0 4 20 20 20 20 20 20 20 280 280 24 280 280 9 280 0 280 280 264 280 280 280 0 0 0 0 8 280 0 0 0 0 0 0 0 0 0 0 0 0 0 0 0 
0 0 0 0 0 0 0 0 0 0 0 0 0 0 0 0 0 0 0 0 0 0 0 0 9 265 8 265 0 265 0 265 265 1 265 265 9 0 265 259 259 259 330 259 330 10 280 330 74 4 4 20 0 4 0 4 0 20 20 0 20 280 0 280 280 280 280 24 280 280 280 280 280 5 0 280 280 280 280 0 0 0 0 0 0 0 0 0 0 0 0 0 0 0 0 0 0 0 0 0 
0 0 0 0 0 0 0 0 0 0 0 0 0 0 265 265 0 0 0 0 0 0 0 0 0 10 265 264 264 8 8 265 265 0 1 75 9 265 0 259 259 259 0 265 265 265 280 74 8 280 0 4 4 0 20 4 4 20 20 20 20 20 0 280 280 280 280 280 280 280 280 280 0 280 5 280 280 0 280 0 0 0 0 0 0 0 0 0 0 0 0 0 0 0 0 0 0 0 0 0 
0 0 0 0 0 0 0 0 0 0 0 0 0 0 0 0 9 265 0 0 0 10 10 265 10 10 265 0 264 264 265 265 265 265 64 75 330 330 265 330 330 330 259 259 265 0 344 280 280 4 0 4 20 4 4 20 0 4 4 20 20 22 0 280 280 280 280 8 280 280 280 280 280 280 280 280 280 280 272 0 0 0 0 0 0 0 0 0 0 0 0 0 0 0 0 0 0 0 0 0 
0 0 0 0 0 0 0 0 0 0 0 0 0 0 0 0 265 0 0 0 0 0 0 328 264 264 10 264 264 264 0 0 265 330 330 64 0 330 330 330 330 330 344 259 11 344 344 344 4 4 4 0 4 132 132 20 20 20 16 129 0 20 280 280 280 280 280 280 0 280 280 280 0 280 280 0 264 280 272 0 0 0 0 0 0 0 0 0 0 0 0 0 0 0 0 0 0 0 0 0 
0 0 0 0 0 0 0 0 0 0 0 0 0 0 0 0 0 0 0 0 0 0 0 0 330 330 264 264 264 264 266 265 330 330 330 330 330 330 330 330 330 344 74 330 330 330 330 330 4 0 344 0 0 132 132 132 132 132 21 0 20 20 280 280 280 280 280 265 280 280 280 280 280 280 280 8 0 280 280 0 0 0 0 0 0 0 0 0 0 0 0 0 0 0 0 0 0 0 0 0 
0 0 0 0 0 0 0 0 0 0 0 0 0 0 0 0 0 0 0 0 0 0 0 0 330 330 10 264 330 264 266 266 330 330 330 330 330 330 0 330 344 330 74 330 330 330 330 4 344 4 0 344 20 344 344 132 132 20 20 20 21 20 20 280 21 280 0 265 0 280 0 280 0 280 280 0 280 0 280 0 0 0 0 0 0 0 0 0 0 0 0 0 0 0 0 0 0 0 0 0 
0 0 0 0 0 0 0 0 0 0 0 0 0 0 0 0 0 0 0 0 0 0 0 0 0 266 0 265 330 266 266 266 330 330 330 10 330 330 330 344 344 344 330 330 3 330 0 344 328 129 4 20 0 20 0 132 132 132 21 20 21 21 20 280 280 21 0 0 80 1 1 0 280 280 280 280 280 280 0 0 0 0 0 0 0 0 0 0 0 0 0 0 0 0 0 0 0 0 0 0 
0 0 0 0 0 0 0 0 0 0 0 0 0 0 0 0 0 0 0 0 0 0 0 0 266 330 10 265 266 266 266 266 330 81 330 330 330 330 330 344 344 344 330 330 330 10 10 10 0 344 344 0 20 132 0 128 132 132 132 0 132 21 21 280 280 8 280 280 280 280 280 16 12 280 280 280 0 0 0 0 0 0 0 0 0 0 0 0 0 0 0 0 0 0 0 0 0 0 0 0 
0 0 0 0 0 0 0 0 0 0 0 0 0 0 0 0 0 0 0 0 0 0 0 0 0 264 330 330 266 330 330 330 81 330 330 330 330 330 330 344 344 0 0 330 344 0 10 344 344 0 20 344 132 132 132 132 132 132 4 132 0 280 21 21 280 280 8 280 280 0 296 296 297 280 16 280 0 280 0 0 0 8 297 0 0 0 0 0 0 0 0 0 0 0 0 0 0 0 0 0 
0 0 0 0 0 0 0 0 0 0 0 0 0 0 0 0 0 0 0 0 0 0 0 330 0 330 330 330 330 330 330 330 0 74 136 330 330 330 0 344 74 74 0 0 344 344 0 330 344 330 0 20 0 132 132 132 132 132 132 132 132 132 280 280 21 280 297 297 280 136 296 296 296 296 16 16 280 0 280 0 0 0 0 0 264 264 264 0 0 0 0 0 0 0 0 0 0 0 0 0 
0 0 0 0 0 0 0 0 0 0 0 0 0 0 0 0 0 0 0 0 0 0 0 330 0 330 0 330 330 330 330 330 330 136 330 330 0 330 0 344 330 330 136 344 0 74 330 0 344 344 330 328 132 128 0 132 132 128 132 132 20 20 297 280 280 280 280 297 296 296 0 296 296 296 0 16 265 280 280 0 297 297 0 0 0 297 0 0 0 0 0 0 0 0 0 0 0 0 0 0 
0 0 0 0 0 0 0 0 0 0 0 0 0 0 0 0 0 0 0 0 0 0 320 330 330 0 330 330 330 330 330 0 330 330 330 330 2 330 330 330 330 330 330 330 330 330 0 330 330 75 328 328 330 0 128 132 128 128 128 297 297 20 20 20 280 297 8 297 297 296 296 80 296 296 297 265 297 280 15 0 297 297 0 264 297 0 0 0 0 0 0 0 0 0 0 0 0 0 0 0 
0 0 0 0 0 0 0 0 0 0 0 0 0 0 0 0 0 0 0 0 0 0 320 330 330 322 0 322 322 322 330 0 10 330 330 330 330 330 0 330 330 330 74 330 330 330 330 128 9 330 328 330 0 330 330 128 0 128 128 0 297 297 20 297 297 297 0 297 296 0 297 297 80 0 297 297 80 297 297 297 0 297 297 297 297 0 0 0 0 0 0 0 0 0 0 0 0 0 0 0 
0 0 0 0 0 0 0 0 0 0 0 0 0 0 0 0 320 0 0 0 0 0 0 320 322 322 322 322 322 322 330 0 0 266 330 3 330 330 344 74 330 0 330 0 328 0 330 330 9 330 330 330 330 0 0 2 0 297 128 0 9 9 297 0 297 297 297 297 297 9 0 297 297 297 297 297 297 265 297 0 297 297 0 297 297 297 0 0 0 0 0 0 0 0 0 0 0 0 0 0 
0 0 0 0 0 0 0 0 0 0 0 0 0 0 0 0 320 320 0 0 322 322 0 0 0 0 322 322 322 322 330 322 322 330 330 330 330 330 74 330 74 330 0 328 328 330 330 330 330 330 0 330 330 8 0 0 297 1 128 297 297 297 297 281 296 0 8 297 297 297 297 297 1 297 297 297 297 0 0 139 297 297 1 0 0 297 0 0 0 0 0 0 0 0 0 0 0 0 0 0 
0 0 0 0 0 0 0 0 0 0 0 0 0 0 0 0 0 0 0 0 0 0 0 322 322 322 322 322 322 0 330 330 330 330 330 8 330 330 330 330 74 74 330 330 330 328 330 328 330 0 330 344 330 8 0 281 1 0 8 128 297 297 297 9 0 297 297 265 8 8 297 297 0 297 297 297 297 10 0 297 297 297 0 0 0 0 0 0 0 0 0 0 0 0 0 0 0 0 0 0 
0 0 0 0 0 0 0 0 0 0 0 0 0 0 0 0 0 0 0 0 0 0 322 1 0 322 322 322 322 322 2 0 330 74 330 330 330 330 330 330 74 0 74 330 330 330 328 328 328 330 330 330 344 8 344 0 281 296 296 297 297 297 297 297 297 297 297 297 297 0 289 297 297 297 289 289 297 10 297 297 0 0 0 0 0 0 0 0 0 0 0 0 0 0 0 0 0 0 0 0 
0 0 0 0 0 0 0 0 0 0 0 0 0 0 0 0 0 0 0 0 10 322 0 3 1 322 0 0 74 9 330 330 330 330 330 330 330 330 75 75 74 0 0 330 330 330 330 328 8 344 330 328 0 330 330 0 296 296 281 297 297 297 297 297 297 297 297 297 297 265 289 297 41 289 289 0 297 297 297 0 0 0 0 0 0 0 0 0 0 0 0 0 0 0 0 0 0 0 0 0 
0 0 0 0 0 0 0 0 0 0 0 0 0 0 0 0 0 0 0 0 0 266 266 0 3 0 322 330 9 73 330 330 330 330 330 0 75 75 75 73 328 330 330 328 330 330 330 330 8 344 138 0 328 344 281 281 328 281 1 281 297 297 265 297 297 296 297 297 297 297 0 297 297 297 297 297 0 0 289 0 0 0 0 0 0 0 0 0 0 0 0 0 0 0 0 0 0 0 0 0 
0 0 0 0 0 0 0 0 0 0 0 0 0 0 0 0 0 0 0 0 0 0 0 322 322 330 330 330 330 330 330 330 330 330 74 74 266 74 74 0 330 328 393 330 330 0 344 14 0 344 344 80 80 9 281 344 344 281 281 297 281 281 297 281 281 297 297 297 297 297 1 297 297 297 297 297 11 0 0 0 0 0 0 0 0 0 0 0 0 0 0 0 0 0 0 0 0 0 0 0 
0 0 0 0 0 0 0 0 0 0 0 0 0 0 0 0 0 0 0 320 0 0 0 0 322 330 322 330 330 330 330 330 0 0 266 266 330 74 330 330 328 328 10 2 2 330 393 344 88 344 344 73 80 281 281 344 0 344 344 281 281 281 281 281 297 297 0 297 297 297 297 297 0 297 265 297 297 0 0 0 0 0 0 0 0 0 0 0 0 0 0 0 0 0 0 0 0 0 0 0 
0 0 0 0 0 0 0 0 0 0 0 0 0 0 0 0 0 0 0 0 0 0 0 320 320 330 330 78 330 330 330 330 330 0 74 74 266 330 330 72 328 328 2 328 328 393 344 80 344 344 344 344 344 344 344 344 344 344 9 281 8 0 281 297 281 297 297 297 297 297 297 297 139 297 297 297 297 297 0 0 0 0 0 0 0 0 0 0 0 0 0 0 0 0 0 0 0 0 0 0 
0 0 0 0 0 0 0 0 0 0 0 0 0 0 0 0 0 0 0 0 0 320 320 320 330 330 330 330 330 266 81 330 320 320 328 0 0 330 330 0 328 328 393 328 8 393 344 344 1 1 344 344 344 344 0 344 344 344 0 281 281 281 281 296 297 297 297 0 297 281 0 0 297 297 297 297 297 0 0 0 0 0 0 0 0 0 0 0 0 0 0 0 0 0 0 0 0 0 0 0 
0 0 0 0 0 0 0 0 0 0 0 0 0 0 0 0 0 0 330 320 320 320 320 320 64 0 320 330 330 330 266 81 81 64 330 320 330 0 330 330 328 328 328 393 393 393 80 344 344 281 281 344 344 344 344 344 344 344 281 281 281 281 281 296 281 297 139 139 297 16 41 297 297 297 297 297 297 265 0 0 0 0 0 0 0 0 0 0 0 0 0 0 0 0 0 0 0 0 0 0 
0 0 0 0 0 0 0 0 0 0 0 0 0 0 0 0 0 330 0 0 320 320 320 320 64 320 330 0 11 11 9 330 320 320 2 330 8 330 320 320 330 330 393 393 393 393 265 393 281 281 344 281 344 0 281 281 281 344 281 281 281 281 281 281 281 281 281 297 16 15 1 297 0 9 9 297 265 137 0 0 0 0 0 0 0 0 0 0 0 0 0 0 0 0 0 0 0 0 0 0 
0 0 0 0 0 0 0 0 0 0 0 0 0 0 0 0 330 0 0 330 330 320 320 320 320 0 320 330 0 330 330 64 320 320 2 330 330 330 72 330 330 393 392 393 393 393 393 393 344 344 344 344 344 265 281 281 25 0 344 281 281 281 281 281 281 281 297 281 297 297 297 297 297 297 8 9 265 265 265 265 0 0 0 0 0 0 0 0 0 0 0 0 0 0 0 0 0 0 0 0 
0 0 0 0 0 0 0 0 0 0 0 0 0 0 0 0 0 320 330 0 330 320 320 330 8 320 320 330 10 330 64 64 0 320 330 320 0 80 320 0 0 393 393 392 393 392 344 393 344 344 344 344 344 9 281 0 344 344 344 281 281 281 281 281 281 281 281 281 297 16 297 16 297 297 0 297 265 265 265 265 0 0 0 0 0 0 0 0 0 0 0 0 0 0 0 0 0 0 0 0 
0 0 0 0 0 0 0 0 0 0 0 0 0 0 0 0 0 0 320 330 0 139 330 320 2 320 320 2 320 320 330 330 320 0 0 0 0 320 320 2 393 393 392 392 392 0 0 0 393 344 17 17 9 8 281 344 344 344 281 265 281 281 281 281 281 281 281 281 16 0 16 297 0 297 297 297 2 265 265 265 265 0 0 0 0 0 0 0 0 0 0 0 0 0 0 0 0 0 0 0 
0 0 0 0 0 0 0 0 0 0 0 0 0 0 0 0 0 330 0 330 330 330 320 0 320 0 320 1 320 320 320 0 320 320 330 330 330 0 320 392 0 393 393 393 393 392 0 0 328 136 0 281 281 281 281 344 344 281 281 281 0 0 281 281 281 281 281 281 281 16 265 265 0 0 265 265 265 9 265 0 265 0 0 0 0 0 0 0 0 0 0 0 0 0 0 0 0 0 0 0 
0 0 0 0 0 0 0 0 0 0 0 0 0 0 0 0 0 0 0 330 0 320 72 320 320 320 320 320 320 330 320 330 320 320 330 330 330 0 330 0 392 392 392 392 393 0 344 344 0 273 281 281 281 0 281 0 344 344 344 281 281 281 281 281 0 281 281 281 264 0 0 0 265 0 265 265 265 265 265 0 0 0 0 0 0 0 0 0 0 0 0 0 0 0 0 0 0 0 0 0 
0 0 0 0 0 0 0 0 0 0 0 0 0 0 0 0 0 0 0 320 0 0 320 320 320 320 320 0 0 0 320 330 320 320 320 320 330 64 64 392 393 392 0 392 392 0 393 328 273 25 273 281 273 281 281 257 344 344 344 281 281 281 281 18 265 265 281 264 0 297 0 297 0 265 265 0 265 265 265 0 0 0 0 0 0 0 0 0 0 0 0 0 0 0 0 0 0 0 0 0 
0 0 0 0 0 0 0 0 0 0 0 0 0 0 0 0 0 0 0 0 320 0 320 320 320 320 320 320 320 330 320 320 0 320 320 320 320 320 393 0 393 393 392 392 393 393 393 393 273 273 25 128 281 273 0 280 0 281 0 281 281 281 281 265 0 281 0 281 8 281 281 0 281 0 265 265 265 265 265 0 0 0 0 0 0 0 0 0 0 0 0 0 0 0 0 0 0 0 0 0 
0 0 0 0 0 0 0 0 0 0 0 0 0 0 0 0 320 0 0 320 320 0 320 320 320 320 320 320 320 320 320 0 320 320 320 320 320 320 393 393 0 393 393 392 393 8 392 393 273 273 273 273 273 265 2 0 281 281 281 281 281 281 281 281 265 0 281 281 1 281 281 281 265 265 0 0 265 265 265 265 0 0 0 0 0 0 0 0 0 0 0 0 0 0 0 0 0 0 0 0 
0 0 0 0 0 0 0 0 0 0 0 0 0 0 0 0 0 0 0 320 320 0 0 0 320 320 320 320 320 64 320 0 320 320 320 320 320 320 0 393 393 393 0 393 0 392 393 273 273 273 273 273 273 0 281 281 273 281 281 281 281 281 281 265 280 281 281 281 281 0 281 281 265 265 0 265 265 265 265 265 0 0 0 0 0 0 0 0 0 0 0 0 0 0 0 0 0 0 0 0 
0 0 0 0 0 0 0 0 0 0 0 0 0 0 0 0 0 0 0 0 0 0 0 0 1 320 320 320 320 320 64 320 0 320 320 320 320 320 0 320 392 8 392 392 393 393 393 0 273 273 273 273 273 0 0 281 273 281 281 281 281 281 281 0 281 280 265 281 281 265 281 281 281 281 0 265 265 0 265 265 265 0 0 0 0 0 0 0 0 0 0 0 0 0 0 0 0 0 0 0 
0 0 0 0 0 0 0 0 0 0 0 0 0 0 0 0 0 0 0 0 0 0 0 0 0 0 0 320 320 320 320 320 320 320 0 320 320 320 320 8 320 392 392 393 393 393 393 393 273 273 273 0 273 0 265 281 8 281 281 281 281 281 281 0 0 0 265 265 265 281 0 281 265 0 265 0 9 265 281 265 0 0 0 0 0 0 0 0 0 0 0 0 0 0 0 0 0 0 0 0 
0 0 0 0 0 0 0 0 0 0 0 0 0 0 0 0 0 0 0 0 0 0 0 0 0 0 320 320 320 0 320 320 320 0 320 128 320 320 0 320 392 392 0 393 320 393 256 0 393 0 281 25 0 273 281 273 273 281 281 281 281 0 281 0 0 0 265 265 281 265 281 0 0 0 0 0 265 265 265 0 265 0 0 0 0 0 0 0 0 0 0 0 0 0 0 0 0 0 0 0 
0 0 0 0 0 0 0 0 0 0 0 0 0 0 0 0 0 0 0 0 0 0 0 0 0 0 320 0 0 0 0 320 320 320 0 320 320 320 8 8 64 392 256 0 393 0 393 256 393 393 25 281 0 0 281 281 0 281 265 264 0 8 8 281 0 281 0 281 265 265 1 0 0 281 281 0 0 265 0 0 0 0 0 0 0 0 0 0 0 0 0 0 0 0 0 0 0 0 0 0 
0 0 0 0 0 0 0 0 0 0 0 0 0 0 0 0 0 0 0 0 0 0 0 0 0 0 0 0 0 0 0 320 0 320 320 320 320 320 64 256 256 320 320 7 393 393 256 0 0 0 0 0 0 136 0 281 8 265 264 264 264 0 0 0 281 0 16 0 265 265 0 0 0 0 0 281 281 0 265 0 0 0 0 0 0 0 0 0 0 0 0 0 0 0 0 0 0 0 0 0 
0 0 0 0 0 0 0 0 0 0 0 0 0 0 0 0 0 0 0 0 0 0 0 0 0 0 0 0 0 0 0 0 320 320 0 320 0 0 320 64 256 256 320 0 393 256 0 0 0 0 0 0 0 0 281 0 0 16 264 8 0 0 265 0 0 0 281 0 0 0 0 0 0 0 0 281 281 281 0 0 0 0 0 0 0 0 0 0 0 0 0 0 0 0 0 0 0 0 0 0 
0 0 0 0 0 0 0 0 0 0 0 0 0 0 0 0 0 0 0 0 0 0 0 0 0 0 0 0 0 0 0 0 0 320 0 320 0 0 0 0 0 0 0 0 0 0 265 0 0 0 0 0 0 0 0 281 0 0 0 0 0 0 0 0 0 281 0 281 0 0 0 0 0 0 0 281 0 0 0 0 0 0 0 0 0 0 0 0 0 0 0 0 0 0 0 0 0 0 0 0 
0 0 0 0 0 0 0 0 0 0 0 0 0 0 0 0 0 0 0 0 0 0 0 0 0 0 0 0 0 0 0 0 0 0 0 320 0 0 0 0 0 0 256 0 0 393 265 0 0 0 281 0 0 0 0 0 281 0 0 264 264 0 0 0 0 0 0 281 0 0 0 0 0 0 0 0 0 0 0 0 0 0 0 0 0 0 0 0 0 0 0 0 0 0 0 0 0 0 0 0 
0 0 0 0 0 0 0 0 0 0 0 0 0 0 0 0 0 0 0 0 0 0 0 0 0 0 0 0 0 0 0 0 0 0 0 0 0 0 0 0 0 0 0 256 0 0 265 0 0 0 0 0 0 0 0 281 0 0 0 0 264 0 0 0 0 0 0 0 0 0 0 0 0 0 0 0 0 0 0 0 0 0 0 0 0 0 0 0 0 0 0 0 0 0 0 0 0 0 0 0 
0 0 0 0 0 0 0 0 0 0 0 0 0 0 0 0 0 0 0 0 0 0 0 0 0 0 0 0 0 0 0 0 0 0 0 320 0 0 0 0 0 0 0 0 0 265 0 0 0 0 0 0 0 0 18 0 281 0 0 0 0 0 0 0 0 0 0 0 0 0 0 0 0 0 0 0 0 0 0 0 0 0 0 0 0 0 0 0 0 0 0 0 0 0 0 0 0 0 0 0 
0 0 0 0 0 0 0 0 0 0 0 0 0 0 0 0 0 0 0 0 0 0 0 0 0 0 0 0 0 0 0 0 0 0 0 0 0 0 0 0 0 0 0 0 0 0 0 0 0 0 0 0 0 0 0 0 0 0 0 0 0 0 0 0 0 0 0 0 0 0 0 0 0 0 0 0 0 0 0 0 0 0 0 0 0 0 0 0 0 0 0 0 0 0 0 0 0 0 0 0 
0 0 0 0 0 0 0 0 0 0 0 0 0 0 0 0 0 0 0 0 0 0 0 0 0 0 0 0 0 0 0 0 0 0 0 0 0 0 0 0 0 0 0 0 0 0 0 0 0 0 0 0 0 0 0 0 0 0 0 0 0 0 0 0 0 0 0 0 0 0 0 0 0 0 0 0 0 0 0 0 0 0 0 0 0 0 0 0 0 0 0 0 0 0 0 0 0 0 0 0 
0 0 0 0 0 0 0 0 0 0 0 0 0 0 0 0 0 0 0 0 0 0 0 0 0 0 0 0 0 0 0 0 0 0 0 0 0 0 0 0 0 0 0 0 0 0 0 0 0 0 0 0 0 0 0 0 0 0 0 0 0 0 0 0 0 0 0 0 0 0 0 0 0 0 0 0 0 0 0 0 0 0 0 0 0 0 0 0 0 0 0 0 0 0 0 0 0 0 0 0 
0 0 0 0 0 0 0 0 0 0 0 0 0 0 0 0 0 0 0 0 0 0 0 0 0 0 0 0 0 0 0 0 0 0 0 0 0 0 0 0 1 0 0 0 0 0 0 0 0 0 0 0 0 0 0 0 0 0 0 0 0 0 0 0 0 0 0 0 0 0 0 0 0 0 0 0 0 0 0 0 0 0 0 0 0 0 0 0 0 0 0 0 0 0 0 0 0 0 0 0 
0 0 0 0 0 0 0 0 0 0 0 0 0 0 0 0 0 0 0 0 0 0 0 0 0 0 0 0 0 0 0 0 0 0 0 0 0 0 0 0 0 1 0 0 0 0 0 0 0 0 0 0 0 0 0 0 0 0 0 0 0 0 0 0 0 0 0 0 0 0 0 0 0 0 0 0 0 0 0 0 0 0 0 0 0 0 0 0 0 0 0 0 0 0 0 0 0 0 0 0 
0 0 0 0 0 0 0 0 0 0 0 0 0 0 0 0 0 0 0 0 0 0 0 0 0 0 0 0 0 0 0 0 0 0 0 0 0 0 0 0 0 0 0 0 0 0 0 0 0 0 0 0 0 0 0 0 0 0 0 0 0 0 0 0 0 0 0 0 0 0 0 0 0 0 0 0 0 0 0 0 0 0 0 0 0 0 0 0 0 0 0 0 0 0 0 0 0 0 0 0 
0 0 0 0 0 0 0 0 0 0 0 0 0 0 0 0 0 0 0 0 0 0 0 0 0 0 0 0 0 0 0 0 0 0 0 0 0 0 0 0 0 0 0 0 0 0 0 0 0 0 0 0 0 0 0 0 0 0 0 0 0 0 0 0 0 0 0 0 0 0 0 0 0 0 0 0 0 0 0 0 0 0 0 0 0 0 0 0 0 0 0 0 0 0 0 0 0 0 0 0 
0 0 0 0 0 0 0 0 0 0 0 0 0 0 0 0 0 0 0 0 0 0 0 0 0 0 0 0 0 0 0 0 0 0 0 0 0 0 0 0 0 0 0 0 0 0 0 0 0 0 0 0 0 0 0 0 0 0 0 0 0 0 0 0 0 0 0 0 0 0 0 0 0 0 0 0 0 0 0 0 0 0 0 0 0 0 0 0 0 0 0 0 0 0 0 0 0 0 0 0 
0 0 0 0 0 0 0 0 0 0 0 0 0 0 0 0 0 0 0 0 0 0 0 0 0 0 0 0 0 0 0 0 0 0 0 0 0 0 0 0 0 0 0 0 0 0 0 0 0 0 0 0 0 0 0 0 0 0 0 0 0 0 0 0 0 0 0 0 0 0 0 0 0 0 0 0 0 0 0 0 0 0 0 0 0 0 0 0 0 0 0 0 0 0 0 0 0 0 0 0 
0 0 0 0 0 0 0 0 0 0 0 0 0 0 0 0 0 0 0 0 0 0 0 0 0 0 0 0 0 0 0 0 0 0 0 0 0 0 0 0 0 0 0 0 0 0 0 0 0 0 0 0 0 0 0 0 0 0 0 0 0 0 0 0 0 0 0 0 0 0 0 0 0 0 0 0 0 0 0 0 0 0 0 0 0 0 0 0 0 0 0 0 0 0 0 0 0 0 0 0 
0 0 0 0 0 0 0 0 0 0 0 0 0 0 0 0 0 0 0 0 0 0 0 0 0 0 0 0 0 0 0 0 0 0 0 0 0 0 0 0 0 0 0 0 0 0 0 0 0 0 0 0 0 0 0 0 0 0 0 0 0 0 0 0 0 0 0 0 0 0 0 0 0 0 0 0 0 0 0 0 0 0 0 0 0 0 0 0 0 0 0 0 0 0 0 0 0 0 0 0 
0 0 0 0 0 0 0 0 0 0 0 0 0 0 0 0 0 0 0 0 0 0 0 0 0 0 0 0 0 0 0 0 0 0 0 0 0 0 0 0 0 0 0 0 0 0 0 0 0 0 0 0 0 0 0 0 0 0 0 0 0 0 0 0 0 0 0 0 0 0 0 0 0 0 0 0 0 0 0 0 0 0 0 0 0 0 0 0 0 0 0 0 0 0 0 0 0 0 0 0 
0 0 0 0 0 0 0 0 0 0 0 0 0 0 0 0 0 0 0 0 0 0 0 0 0 0 0 0 0 0 0 0 0 0 0 0 0 0 0 0 0 0 0 0 0 0 0 0 0 0 0 0 0 0 0 0 0 0 0 0 0 0 0 0 0 0 0 0 0 0 0 0 0 0 0 0 0 0 0 0 0 0 0 0 0 0 0 0 0 0 0 0 0 0 0 0 0 0 0 0 
0 0 0 0 0 0 0 0 0 0 0 0 0 0 0 0 0 0 0 0 0 0 0 0 0 0 0 0 0 0 0 0 0 0 0 0 0 0 0 0 0 0 0 0 0 0 0 0 0 0 0 0 0 0 0 0 0 0 0 0 0 0 0 0 0 0 0 0 0 0 0 0 0 0 0 0 0 0 0 0 0 0 0 0 0 0 0 0 0 0 0 0 0 0 0 0 0 0 0 0 
0 0 0 0 0 0 0 0 0 0 0 0 0 0 0 0 0 0 0 0 0 0 0 0 0 0 0 0 0 0 0 0 0 0 0 0 0 0 0 0 0 0 0 0 0 0 0 0 0 0 0 0 0 0 0 0 0 0 0 0 0 0 0 0 0 0 0 0 0 0 0 0 0 0 0 0 0 0 0 0 0 0 0 0 0 0 0 0 0 0 0 0 0 0 0 0 0 0 0 0 
